map_id,event_id,course_id,que_id,start_area_id,name,sheet_id,end_area_id
10001,10001,10001,bgm_M32,10001101,"타르굼 지방",bgm_M32,10001101
10002,10002,10002,bgm_M98_2,10002101,"마시나 지방",bgm_M98,10002101
10003,10003,10003,bgm_M106,10003101,"랜드솔 교외",bgm_M106,10003101
10004,10004,10004,bgm_M112,10004101,"타파스 해변 주변",bgm_M112,10004101
10005,10005,10005,bgm_M121,10005101,"일시온의 외딴섬",bgm_M121,10005101
10006,10006,10006,bgm_M128,10006101,"왕도 랜드솔",bgm_M128,10006101
10007,10007,10007,bgm_M135,10007101,"랜드솔 근교",bgm_M135,10007101
10008,10008,10008,bgm_M121,10008101,"랜드솔 근교",bgm_M121,10008101
10009,10009,10009,bgm_M171,10009101,"크리스마스",bgm_M171,10009101
10010,10010,10010,bgm_M121,10010101,"신전으로 가는 길",bgm_M121,10010101
10011,10011,10011,bgm_M189,10011101,"발렌타인",bgm_M189,10011101
10012,10012,10012,bgm_M206,10012101,"왕도 랜드솔",bgm_M206,10012101
10013,10013,10013,bgm_M215,10013101,"마나리아",bgm_M215,10013101
10014,10014,10014,bgm_M32,10014101,"타르굼 지방",bgm_M32,10014101
