arcade,id,poster,reward_get,jukebox,vegetable,stock,nebbia
0,1,0,1,0,0,0,0
0,2,0,2,0,0,0,0
0,3,0,3,0,0,0,0
0,4,0,4,0,0,0,0
0,5,0,5,0,0,0,0
0,6,0,6,0,0,0,0
0,7,0,7,0,0,0,0
0,8,0,8,0,0,0,0
0,9,0,0,1,0,0,0
0,10,0,0,0,0,0,1
0,11,0,11,0,0,0,0
0,12,0,12,0,0,0,0
1,13,0,0,0,0,0,0
0,14,0,0,0,0,0,0
0,15,0,0,0,0,0,0
0,16,0,0,0,1,0,0
0,17,10056,0,0,0,0,0
0,18,0,0,0,0,0,0
0,19,0,19,0,0,0,0
0,20,10061,0,0,0,0,0
0,21,0,0,0,0,0,0
0,22,0,0,0,0,0,0
0,23,0,0,0,0,23,0
0,24,0,0,0,0,0,0
0,25,0,25,0,0,0,0
0,26,10088,0,0,0,0,0
0,27,10102,0,0,0,0,0
0,28,0,28,0,0,0,0
0,29,30001,0,0,0,0,0
0,30,0,30,0,0,0,0
