reward_type,mission_reward_id,icon_type,reward_id,id,reward_num
15,32001001,1002,10701100,1,1
15,32001002,1002,10701101,2,1
15,32001003,1002,10701102,3,1
15,32001004,1003,10701103,4,1
15,32001005,1003,10701104,5,1
