reward_id,mission_reward_id,icon_type,reward_type,id,reward_num
10701100,32001001,1002,15,1,1
10701101,32001002,1002,15,2,1
10701102,32001003,1002,15,3,1
10701103,32001004,1003,15,4,1
10701104,32001005,1003,15,5,1
