reward_type,icon_type,id,mission_reward_id,reward_id,reward_num
15,1002,1,32001001,10701100,1
15,1002,2,32001002,10701101,1
15,1002,3,32001003,10701102,1
15,1003,4,32001004,10701103,1
15,1003,5,32001005,10701104,1
