icon_type,reward_id,id,reward_type,mission_reward_id,reward_num
1002,10701100,1,15,32001001,1
1002,10701101,2,15,32001002,1
1002,10701102,3,15,32001003,1
1003,10701103,4,15,32001004,1
1003,10701104,5,15,32001005,1
